TTTTTTTTTTTTTTTTTTTTTTTTTTTTTTTTTTTTTTTTTTTTTTTTTTTTT
TTTTTTGGGGGGGGGGGGGGGGGGTTTTTGGGGGGG!)))))))))))@GTTT
TTTTTGGGGGGTTTTTTTTGGGGGTTTTTGGTTTGG&WWWWWWWWWWW(GGGT
T4GGGGGGGGGTTGGGGGGGGGGGTTTTTGGTTGGG&WWWWWWWWWWW(GGrG
TGGGTGGGGGGTTGGGGGGGGGG5TTTTTGGTTGGG%$$$$$$$$$$$^GGGT
TGGGTGGGGGGTTGGGGGGGGGGGGGGGGGGTTGGGTTTTTTTGGGGGGGGGT
TGGGGTTTTTTTTTTTTTTTTTTTTTTTTTTTTTGGTTTTTGGGTTTTTTTTT
TGGGTGGGTGGGGGGGGGGGTGGGGG3TTTTTTTGGTTTTGGGGTTTTTTTTT
TGGGGTGTGGGTTTGGGGGGTGGGTGGTTTTTTTGGGGGGGTTTTTTTTTTTT
TGGGGGTGGGGTTGGGGTTTGGGGTGGTTTTTTTTTTTTTTTTTTTTTTTTTT
TGGGGGGGGGGTTGGGTGGGGGTTTGGGTTTTTTTGGGGGGGGTTTTTTTTTT
TGGGGGGGGGGTTGGGGGGGGGTGGGGGGGGGGGGGGGGGGTTTTTTTTTTTT
TTTTTTTTTTTTTTTTTTTTTTTTTTTTTTTTTTTTTTGTTTTTTTTTTTTTT
TTGGGGGGGGGGGGGGGGGGGGGGGGGGGGGGGGGGGGGGGGGGGGGGGG2TT
TTGGTTTTTTTTTTTTTTTTTTTTTTTTTTTTTTTTTTTTTTTTTTTTGGTTT
TTGGTTGGGGGGGGGGGGGGGGGGGGGGGGGGGGGGGGGGGGGGGGTTGGTTT
TTGGTTGGTTTTTTTTTTTTTTTTTTTTTTTTTTTTTTTTTTTTGGTTGGTTT
TTGGGGGGGGGGGGGGGGGGGGGGGGGGGGGGGGGGGGGGGGGGGGGGGGTTT
TTTTTTTTTTTTTTTTTTTTTTTTTTTTTTTTTTTTTTTTTTTTTT1GGGPGG
TTTTTTTTTTTTTTTTTTTTTTTTTTTTTTTTTTTTTTTTTTTTTTTTTTTTT