TTTTTTTTTTTTTTTTTTTTTTTTTTTTTTTTTTTTTTTTTTTTTTTTTTTTT
TTTTTTGGGGGGGGGGGGGGGGGGTTTTTGGGGGGG!)))))))))))@GTTT
TTTTTGGGGGGTTTTTTTTOGGGGTTTTTGGTTTGG&WWWWWWWWWWW(GGGT
TGGGGGGGGGGTTGGGGGGGGGGGTTTTTGGTTGGG&WWWWWWWWWWW(GGrG
TGGGTGGGGGGTTGGGGGGTTTTTTTTTTGGTTGGG%$$$$$$$$$$$^GGGT
TGGGTGGGGGGTTOGGGGGGGGGGGGGGGGGTTGGGTTTTTTTGGGGGGGGGT
TGGGGTTTTTTTTTTTTTTTTTTTTTTTTTTTTTGGTTTTTGGGTTTTTTTTT
TGGGTGGGTGGGGGGGGGGGTGGGGGGTTTTTTTGGTTTTGGGOTTTTTTTTT
TGGGGTGTGGGTTTGGGGGGTGGGTGGTTTTTTTGGGGGGGTTTTTTTTTTTT
TGGGGGTGGGGTTGGGGTTTGGGGTGGTTTTTTTTTTTTTTTTTTTTTTTTTT
TOGGGGGGGGGTTGGGTGGGGGTTTGGGTTTTTTTGGGGGGGGGGGGGGGGGT
TGGGGGGGGGGTTGGGGGGGGGTOGGGGGGGGGGGGGGGGGTTGGGGGGGGGP
TTTTTTTTTTTTTTTTTTTTTTTTTTTTTTTTTTTTTTTTTTTTTTTTTTTTT
TTTTTTTTTTTTTTTTTTTTTTTTTTTTTTTTTTTTTTTTTTTTTTTTTTTTT
TTTTTTTTTTTTTTTTTTTTTTTTTTTTTTTTTTTTTTTTTTTTTTTTTTTTT
TTTTTTTTTTTTTTTTTTTTTTTTTTTTTTTTTTTTTTTTTTTTTTTTTTTTT
TTTTTTTTTTTTTTTTTTTTTTTTTTTTTTTTTTTTTTTTTTTTTTTTTTTTT
TTTTTTTTTTTTTTTTTTTTTTTTTTTTTTTTTTTTTTTTTTTTTTTTTTTTT
TTTTTTTTTTTTTTTTTTTTTTTTTTTTTTTTTTTTTTTTTTTTTTTTTTTTT
TTTTTTTTTTTTTTTTTTTTTTTTTTTTTTTTTTTTTTTTTTTTTTTTTTTTT