TTTTTTTTTTTTTTTTTTTTTTTTTTTTTTTTTTTTTTTTTTTTTTTTTTTTT
TTTTTTGGGGGGGGGGGGGGGGGGTTTTTGGGGGGG!)))))))))))@GTTT
TTTTTGGGGGGTTTTTTTTOGGGGTTTTTGGTTTGG&WWWWWWWWWWW(GGGT
TGGGGGGGGGGTTGGGGGGGGGGGTTTTTGGTTGGG&WWWWWWWWWWW(GGrG
TGGGTGGGGGGTTGGGGGGTTTTTTTTTTGGTTGGG%$$$$$$$$$$$^GGGT
TGGGTGGGGGGTTOGGGGGGGGGGGGGGGGGTTGGGTTTTTTTGGGGGGGGGT
TGGGGTTTTTTTTTTTTTTTTTTTTTTTTTTTTTGGTTTTTGGGTTTTTTTTT
TGGGTGGGTGGGGGGGGGGGTGGGGGGTTTTTTTGGTTTTGGGOTTTTTTTTT
TGGGGTGTGGGTTTGGGGGGTGGGTGGTTTTTTTGGGGGGGTTTTTTTTTTTT
TGGGGGTGGGGTTGGGGTTTGGGGTGGTTTTTTTTTTTTTTTTTTTTTTTTTT
TOGGGGGGGGGTTGGGTGGGGGTTTGGGTTTTTTTGGGGGGGGTTTTTTTTTT
TGGGGGGGGGGTTGGGGGGGGGTOGGGGGGGGGGGGGGGGGTTTTTTTTTTTT
TTTTTTTTTTTTTTTTTTTTTTTTTTTTTTTTTTTTTTGTTTTTTTTTTTTTT
TTGGGGGGGGGGGGGGGGGGGGGGGGGGGGGGGGGGGGGGGGGGGGGGGGGTT
TTGGTTTTTTTTTTTTTTTTTTTTTTTTTTTTTTTTTTTTTTTTTTTTGGTTT
TTGGTTGGGGGGGGGGGGGGGGGGGGGGGGGGGGGGGGGGGGGGGGTTGGTTT
TTGGTTGGTTTTTTTTTTTTTTTTTTTTTTTTTTTTTTTTTTTTGGTTGGTTT
TTGGGGGGGGGGGGGGGGGGGGGGGGGGGGGGGGGGGGGGGGGGGGGGGGTTT
TTTTTTTTTTTTTTTTTTTTTTTTTTTTTTTTTTTTTTTTTTTTTTGGGGPGG 
TTTTTTTTTTTTTTTTTTTTTTTTTTTTTTTTTTTTTTTTTTTTTTTTTTTTT