TTTTTTTTTTTTTTTTTTTTTTTTTTTTTTTTTTTTTTTTTTTTTTTTTTTTT
GGPGGGGGGGGGGGGTTTTTTTTTTTTTTTTGGGGGGGGGGGGGGGGGGGGTT
TTTGGTTTTTTTTGGTTTTGGGGGGGGGGTTGGTTTTTTTTTTTTTTTTGGTT
TTTGGTTGGGGTTGGTTTTGGTTTTTTGGTTGGTTGGGGGGGGGGGGTTGGTT
TTTGGTTGGNTTGGGGGGGGGTTTTTTGGGGGGTTGGNTTTTTTTGGTTGGTT
TTTGGTTGGTTTTTTTTTTTTTTTTTTTTTTTTTTGGTTTTTTTTGGTTGGTT
TTTGGGGGGGGGGGGGGGGGGGGGGGGGGGGGGGGGGGGGGGGGGGGTTGGTT
TTTTTTTTTTTTTTTTTTTTTTTTTTGGTTTTTTTTTTTTTTTTTTTTGGTTT
TTGGGGGGGGGGGGGGGGGGGGTTTTGGTTGGGGGGGGGGGGGGGGGGGGTTT
TTGGTTTTTTTTTTTTTTTTGGTTTTGGTTGGTTTTTTTTTTTTTTTTGGTTT
TTGGTTGGGGGGGGGGTTTTGGGGGGGGGGGGTTGGGGGGGGGGGGTTGGTTT
TTGGTTGGTTTTTTGGTTTTTTTTTTTTTTGGTTGGTTTTTTTTGGTTGGTTT
TTGGGGGGTTTTTTGGGGGGGGGGGGTTTTGGGGGGTTTTTTTTGGGGGGTTT
TTTTTTGGTTTTTTTTTTTTTTTTGGTTTTTTTTGGTTTTTTTTTTTTGGTTT
TTGGGGGGGGGGGGGGGGGGGGGGGGGGGGGGGGGGGGGGGGGGGGGGGGTTT
TTGGTTTTTTTTTTTTTTTTTTTTTTTTTTTTTTTTTTTTTTTTTTTTTTTTT
TTGGTTGGGGGGGGGGGGGGGGGGGGGGGGGGGGGGGGGGGGGGGGTTTTTTT
TTGGNTGGTTTTTTTTTTTTTTTTTTTTTTTTTTTTTTTTTTTTGGNTTTrTT
TTGGGGGGGGGGGGGGGGGGGGGGGGGGGGGGGGGGGGGGGGGGGGGGGGTTT
TTTTTTTTTTTTTTTTTTTTTTTTTTTTTTTTTTTTTTTTTTTTTTTTTTTTT