TTTTTTTTTTTTTTTTTTTTTTTTTTTTTTTTTTTTTTTTTTTTTTTTTT
TGGGNGGGGGGTTGGGGGGGGGGGGGGGGGGGGGGTTGGGGGGGGGGGGT
TGPGGGGTGGTTGGTTTTTTTTTTTTTTTTTTGGTTGGTTTTTTTTGGGT
TTTTTTTTGGTTGGTTTTTTTTTTTTTTTTTTGGTTGGTTTTTTTTGGGT
TTGGTTTTGGGGGGTTGGGGGGGGGGGGGGGGGGTTGGGGGGGGTTGGGT
TTGGTTTTTTTTGGTTGGTTTTTTTTTTTTTTTTTTTTTTTTGGTTTTTT
TGGGGGGGGGGGNGGGGGTTGGGGGGGGGGGGGGGGGGGGGGGGTTGGGT
TGTTTTTTTTTTTTTTGGTTGGTTTTTTTTTTTTTTTTTTTTTTTTGGGT
TGTTTTTTTTTTTTTTGGTTGGTTGGGGGGGGGGGGGGGGGGGGGGGGGT
TGGGGGGGGGGGGGTTGGTTGGTTGGTTTTTTTTTTTTTTTTTTTTGGGT
TTTTTTTTTTTTGGTTGGGGGGTTGGTTTTTTTTTTTTTTTTTTTTGGGT
TGGGGGGGGGGGNGTTTTTTTTTTGGTTGGGGGGGGGGGGGGGGGGGGGT
TGGGGGGGGGGGTTTTTTTTTTTTTTGGTTTTTTTTTTTTTTTTTTGGGT
TTTTTTTTTTGGGGGGGGGGGGGGGGGGTTGGGGGGGGGGGGGGGGGGGT
TGGGGGGGGGNGTTTTTTTTTTTTTTTTTTTTTTTTTTTTTTTTTTGGGT
TGGGGGGGGGTTTTTTTTTTTTTTTTTTTTTTTTTTTTTTTTTTTTGGGT
TTTTTTTTGGGGGGGGGGGGGGGGGGGGGGGGGGGGGGGGGGGGGGGGGT
TGGGGGGGNGTTTTTTTTTTTTTTTTTTTTTTTTTTTTTTTTTTTTGGrT
TGGGGGGGTTGGGGGGGGGGGGGGGGGGGGGGGGGGGGGGGGGGGGGGGT
TTTTTTTTTTTTTTTTTTTTTTTTTTTTTTTTTTTTTTTTTTTTTTTTTT