TTTTTTTTTTTTTTTTTTTTTTTTTTTTTTTTTTTTTTTTTTTTTTTTTTTTT
TTTTTTGGGGGGGTTTTTTTTTTTGGGGGGGGTTTTTTTTOTTTTGGGGGGTT
TTTTTGGGTTTTGGGGGGTTTTTGGTTTGGGTTGGGGGGGGTTTTGGTTGGTT
TTTTTGGGTTTTTTGGGGTTTTGGGTTTGGTTTGGTTTGGGGTTTGGTTGGTT
TTTTGGGTTTTTOGGGGGGGGGGGGTTTGGTTTGGTTTTTGGGTTGGTTGGTT
TTTGGTTTTTTTTTTTTTTTTTTTTTTTGGGGGGGTTTTTTGGGGGGTTGGTT
TTTGGGGGGGTTTTGGGGGGGGTTGGGTTTTTTTTTTTTTTTTTTTTTTGGTT
TTTTTGTTGGGHGGGGTTTTGGTTGTGTTTGGGGGGGGGTTTTTTTGGGGGTT
TTTTTTTTTTTTTGGTTTTGGGOTGTGGGGGGGTTTTGGTTTTTTGGGGTTTT
TTTTGGGGGGGGTTTTTTTGGGTTGGTTTTTTTTTTTTGTTTTOGGGGTTTTT
TTTTGGTTTTGGTTTTTTGGGGTTTGGGTTTTTTTTTTGGTTGGGGTTTTTTT
PGGGGGOTTTGGGGGGGGGGGTTTTTTGGGTTTTTTTTGGGGGGGTTTTTTTT
TTTTTTTTTTTTTTTTTTTTTTTTTTTTTuTTTTTTTTTTTTTTTTTTTTTTT
TTTTTTTTTTTTTTTTTTTTTTTTTTTTTTTTTTTTTTTTTTTTTTTTTTTTT
TTTTTTTTTTTTTTTTTTTTTTTTTTTTTTTTTTTTTTTTTTTTTTTTTTTTT
TTTTTTTTTTTTTTTTTTTTTTTTTTTTTTTTTTTTTTTTTTTTTTTTTTTTT
TTTTTTTTTTTTTTTTTTTTTTTTTTTTTTTTTTTTTTTTTTTTTTTTTTTTT
TTTTTTTTTTTTTTTTTTTTTTTTTTTTTTTTTTTTTTTTTTTTTTTTTTTTT
TTTTTTTTTTTTTTTTTTTTTTTTTTTTTTTTTTTTTTTTTTTTTTTTTTTTT
TTTTTTTTTTTTTTTTTTTTTTTTTTTTTTTTTTTTTTTTTTTTTTTTTTTTT