TTTTTTTTTTTTTTTTTTTTTTTTTTTTTTTTTTTTTTTTTTTTTTTTTT
TGGGGGGGGGGTTGGGGGGGGGGGGGGGGGGGGGGTTGGGGGGGGGGGGT
TGPGGGGTGGTTGGGGGGGGGG1TTTTTTTTTGGTTGGTTTTTTTTGGGT
TTTTTTGGGGTTGGTTTTTTTTTTTTTTTTTTGGTTGGTTTTTTTTGGGT
TTGGTTGGGGGGGGTTGGGGGGGGGGGGGGGGGGTTGGGGGGGGTTGGGT
TTGGTTTTTTTTGGTTGGTTTTTTTTTTTTTTTTTTTTTTTTGGTTTTTT
TGGGGGGGGGGGGGGGGGTTGGGGGGGGGGGGGGGGGGGGGGGGTTGGGT
TGTTTTTTTTT2GGGGGGTTGGTTTTTTTTTTTTTTTTTTTTTTTTGGGT
TGTTTTTTTTTTTTTTGGTTGGTTGGGGGGGGGGGGGGGGGGGGGGGGGT
TGGGGGGGGGGGGGTTGGTTGGTTGGTTTTTTTTTTTTTTTTTTTTGGGT
TTTTTTTTTTTTGGTTGGGGGGTTGGTTTTTTTTTTTTTTTTTTTTGGGT
TGGGGGGGGGGGGGGGGGGG3TTGTTTGGGGGGGGGGGGGGGGGGGGGGT
TGGGGGGGGGGGTTTTTTTTTTTTTTGGTTTTTTTTTTTTTTTTTTGGGT
TTTTTTTTTTGGGGGGGGGGGGGGGGGGTTGGGGGGGGGGGGGGGGGGGT
TGGGGGGGGGGGTTTTTTTTTTTTGGGGGTTTTTTTTGGGGGTTTTGGGT
TGGGGGGGGGGGGGGGGGGGGGGGGTGTTTTTTTTTTTGGGG4TTTTGGT
TTTTTTTTGGGGGGGGGGGGGGGGGGGTTTTGGGGGGGGGGGGGGGGGGT
TGGGGGGGGGTTTTTTTTTTTTTGGGGTTTTGGGGTTTTTTTTTGGGGrG
T5GGGGGGGGGGGGGGGGGGGGGGGGGGGGGGGGGGGGGGGGGGGGGGGG
TTTTTTTTTTTTTTTTTTTTTTTTTTTTTTTTTTTTTTTTTTTTTTTTTT