TTTTTTTTTTTTTTTTTTTTTdTTTTTTTTTTTTTTTTTTTTTTTTTTTT
TPGGGGGGGGGGGGGGTTGGGGGGGGGGGGGGGGGGGGGGTTGGGGGTTT
TTTGGGGGGGGGTGGTTGGGGGGGGGGGGGTTTTTTTGGTTGGTTTTTTT
TTTGGGTTTTTTTGGTTGGTTTTTTTTTTTTTTTTTTGGTTGGTTTTTTT
TTTGGGGGTTTT1GGGGGGTTGGGGNGGGGGGGGGGGGGGGGGGGGGTTT
TTTTTTGGGTTTTTTTTGGTTGGTTTTTTGGGTTTTTTTTTTTTTTTGGT
TTTGGGGGGGGGGGGGTGGGGGGTTGGGGGGGGGGGGGGGGGGGGGGGGT
TTTGGGGTTTTTTTTTTTTTTGGTTGGTTTTTTTTTTTTTTGGGTTTTTT
T2GGGGGTTTTTTTTTTTTTTNGTTGGTTGGGGGGGGGGGGGGGGG5GGT
TTTGGGGGGGGGGGGGGGGTTGGTTGGTTGGTTTTTTTTTTTTTTTTTTT
TTTGGGTTTTTTTTTTTGGTTGGGGGGTTGGTTTTTTTTTTTTTTTTTTT
TGGGGGGGGGGGGGGGGGGTTTTTTTTTTGGTTNGGGGGGGGGGGGGGGT
TTTGGGGGGGGGGGGGGTTTTTTTTTTTTTTGGTTTTTGGGTTTTTTTTT
TGGGGGTTTTTTTTTGGGGGGGGGGGGGGGGGGTTGGGGGGGGGGGGGGT
TTTGGGGGGGGGGGGGGGGGGGGGGGGGGGGGGTTTTTTTTTGGTTTTTT
TTTGGGGGGGGGGGGTTTTTTTTTTTTTTTTTTTTTTTTTTTGGTTTTTT
T3GGGGTTTTTTTGGGGGGNGGGGGGGGGGGGGGGGGGGGGGGGGGG4TT
TTTGGGGGGGGGGGGTTTTTTTTTTTTTTTTTTTTTTTTTTTTTTTTTTT
TGGGGGGGGGGGGTTGGGGGGGGGGGGGGGGGGGGGGGGGGGGGGGGGTT
TTTTTTTTTTTTTTTTTTTTTTTTTTTTTTTTTTTTTTTTTTTTTTTTTT
