TTTTTTTTTTTTTTTTTTTTTTTTTTTTTTTTTTTTTTTTTTTTTTTTTTTTT
TTGGGGGGGGGGGGGGGGTTTTTTTTTTTTTTTTTTTTTGGGGGGGGGGGGTT
TTGGTTTTTTTTTTTTGGTTTTTGGGGGGGGGTTTTTTTGGTTTTTTTTGGTT
TTGGTTTTGGGGGGTTGGTTTTTGGTTTTTGGTTTTTTTGGTTGGGGTTGGTT
TTGGTTTTGGNTGGTTGGGGGGGGGTTTTTGGGGGGGGGGGTTGGNTGGGGTT
TTGGGGGGGGTTGGTTTTTTTTTTTTTTTTTTTTTTTTTTTTTGGTTTTGGTT
TTTTTTTTTTGGTTTTTGGGGGGGGGGGGGGGGGGGGTTTTTTGGTTTTGGTT
TTGGGGGGGGGGTTTTTGGTTTTTTTTTTTTTTTTGGTTTTTTGGGGGGGGTT
TTGGTTTTTTTTTTTTTGGTTTTGGGGGGGGTTTTGGTTTTTTTTTTTTGGTT
TTGGTTGGGGGGGGGGGGGTTTTGGTTTPTTGGTTTTGGGGGGGGGGGGGGTT
TTGGTTGGTTTTTTTTTTTTTTGGGTTTTTTGGTTTTGGTTTTTTTTTTGGTT
TTGGGGGGGGGGGGGGGGGGGGGTTTTTTTTGGGGGGGGGGGGGGGGGGGGTT
TTTTTTTTTTTTTTTTTTTTTTTGGGGGGGGTTTTTTTTTTTTTTTTTTTTTT
TTGGGGGGGGGGGGGGGGGGGGGGGGGuGGGGGGGGGGGGGGGGGGGGGGGTT
TTGGTTTTTTTTTTTTTTTTTTTTTTTGGTTTTTTTTTTTTTTTTTTTTGGTT
TTGGTTTTGGGGGGGGGGGGGGGGGGGTTGGGGGGGGGGGGGGGGGGTTGGTT
TTGGNTTTGGTTTTTTTTTTTTTTTTTTTTTTTTTTTTTTTTTTTGGTTGGTT
TTGGTTTTGGGGGGGGGGGGGGGGGGGGGNTGGGGGGGGGGGGGGGGTTGGTT
TTGGGGGGGGGGGGGGGGGGGGGGGGGGGGGGGGGGGGGGGGGGGGGGGGTTT
TTTTTTTTTTTTTTTTTTTTTTTTTTTTTTTTTTTTTTTTTTTTTTTTTTTTT