TTTTTTTTTTTTTTTTTTTTTTTTTTTTTTTTTTTTTTTTTTTTTTTTTT
TPGGGGGGGGGGGGGGTTGGGGGGGGGGGGGGGGGGGGGGTTGGGGGGGT
TTTGGGGGGGGGTGGTTGGTTTTTTTTTTTTTTTTTTGGTTGGTTTTTTT
TTTGGGTTTTTTTGGTTGGTTTTTTTTTTTTTTTTTTGGTTGGTTTTTTT
TTTGGGTGGTTTTGGGGGGTTGGGGNGGGGGGGGGGGGGTTGGGGGGGGT
TTTTTTTGGTTTTTTTTGGTTGGTTTTTTTTTTTTTTTTTTTTTTTTGGT
TTTGGGGGGGGGGGGGGGGGGGGTTGGGGGGGGGGGGGGGGGGGGGGGGT
TTTGGGGTTTTTTTTTTTTTTGGTTGGTTTTTTTTTTTTTTTTTTTTTTT
TGGGGGGTTTTTTTTTTTTTTNGTTGGTTGGGGGGGGGGGGGGGGGGGGT
TTTGGGGGGGGGGGGGGGGTTGGTTGGTTGGTTTTTTTTTTTTTTTTTTT
TTTGGGTTTTTTTTTTTGGTTGGGGGGTTGGTTTTTTTTTTTTTTTTTTT
TGGGGGGGGGGGGGGGGGGTTTTTTTTTTGGTTNGGGGGGGGGGGGGGGT
TTTGGGGGGGGGGGGGGTTTTTTTTTTTTTTGGTTTTTTTTTTTTTTTTT
TGGGGGTTTTTTTTTGGGGGGGGGGGGGGGGGGTTGGGGGGGGGGGGGGT
TTTGGGGGGGGGGGGGGTTTTTTTTTTTTTTTTTTTTTTTTTTTTTTTTT
TTTGGGGGGGGGGGGTTTTTTTTTTTTTTTTTTTTTTTTTTTTTTTTTTT
TGGGGGTTTTTTTGGGGGGNGGGGGGGGGGGGGGGGGGGGGGGGGGGGGT
TTTGGGGGGGGGGGGTTTTTTTTTTTTTTTTTTTTTTTTTTTTTTTTTTT
TGGGGGGGGGGGGTTGGGGGGGGGGGGGGGGGGGGGGGGGGGGGGGGGlT
TTTTTTTTTTTTTTTTTTTTTTTTTTTTTTTTTTTTTTTTTTTTTTTTTT
