TTTTTTTTTTTTTTTTTTTTTTTTTTTTTTTTTTTTTTTTTTTTTTTTTTTTT
TTGGGGGGGGGGGGGGGGGGGGGGGGGGGGGGGGGGGGGGGGGGGGGGGGGTT
TTGGTTTTTTTTTTTTTTTTTTTTGGGGGGGGGGTTTTTTTTTTTTTTGGTT
TTPGGTTGGGGGGGGGGGGGGTTGGTTTTTTGGTTGGGGGGGGGGTTGGGTT
TTGGGTTGGNTTTTTTTTGGTTGGGGGGGGGGTTGGNTTTTTTGGTTGGGTT
TTGGGTTGGTTTTTTTTTGGTTTTTTTTTTTTTTGGTTTTTTTGGTTGGGTT
TTGGGGGGGGGGGGGGGGGGGGGGGGGGGGGGGGGGGGGGGGGGGGGGGGTT
TTTTTTTTTTTTTTTTTTTTTTTTTTGGTTTTTTTTTTTTTTTTTTTTGGTT
TTGGGGGGGGGGGGGGGGGGGGTTTTGGTTGGGGGGGGGGGGGGGGGGGGTT
TTGGTTTTTTTTTTTTTTTTGGTTTTGGTTGGTTTTTTTTTTTTTTTTGGTT
TTGGTTGGGGGGGGGGTTTTGGGGGGGGGGGGTTGGGGGGGGGGGGTTGGTT
TTGGTTGGTTTTTTGGTTTTTTTTTTTTTTGGTTGGTTTTTTTTGGTTGGTT
TTGGGGGGTTTTTTGGGGGGGGGGGGTTTTGGGGGGTTTTTTTTGGGGGGTT
TTTTTTGGTTTTTTTTTTTTTTTTGGTTTTTTTTGGTTTTTTTTTTTTGGTT
TTGGGGGGGGGGGGGGGGGGGGGGGGGGGGGGGGGGGGGGGGGGGGGGGGTT
TTGGTTTTTTTTTTTTTTTTTTTTTTTTTTTTTTTTTTTTTTTTTTTTGGTT
TTGGTTGGGGGGGGGGGGGGGGGGGGGGGGGGGGGGGGGGGGGGGGTTGGTT
TTGGNTGGTTTTTTTTTTTTTTTTTTTTTTTTTTTTTTTTTTTTGGTTuGTT
TTGGGGGGGGGGGGGGGGGGGGGGGGGGGGGGGGGGGGGGGGGGGGGGGGTT
TTTTTTTTTTTTTTTTTTTTTTTTTTTTTTTTTTTTTTTTTTTTTTTTTTTT