TTTTTTTTTTTTTTTTTTTTTTTTTTTTTTTTTTTTTTTTTTTTTTTTTTTTT
TTGGGGGGGGGGGGGGGGGGGGGGGGGGGGGGGGGGGGGGGGGGGGGGGGTTT
TTGGTTTTTTTTTTGGTTTTTTTTTTTTTTTTTTGGTTTTTTTTTTTTGGTT
TTGGTTGGGGGGTTGGGGGGGGGGGGGGGGGGTTGGTTGGGGGGGGTTGGTT
TTGGTTGGNTGGTTTTTTTTTTTTTTTTTTGGTTGGNTGGTTTTGGTTGGTT
TTGGTTGGTTGGGGGGGGGGGGGGGGGGTTGGGGGGTTGGGGGGTTGGGGTT
TTGGTTTTTTTTTTTTTTTTTTTTTTTTTTTTTTTTTTTTTTTTTTTTGGTT
TTGGGGGGGGGGGGGGGGGGGGGGGGGGGGGGGGGGGGGGGGGGGGGGGGTT
TTTTTTTTTTTTTTTTTTTTTTTTTTGGTTTTTTTTTTTTTTTTTTTTGGTT
TTGGGGGGGGGGGGGGGGGGGGTTTTGGTTGGGGGGGGGGGGGGGGGGGGTT
TTGGTTTTTTTTTTTTTTTTGGTTTTGGTTGGTTTTTTTTTTTTTTTTGGTT
TTGGTTGGGGGGGGGGTTTTGGGGGGGGGGGGTTGGGGGGGGGGGGTTGGTT
TTPGGTTGGTTTTTTGGTTTTTTTTTTTTTTGGTTGGTTTTTTTTGGTTGGT
TTGGGGGGTTTTTTGGGGGGGGGGGGTTTTGGGGGGTTTTTTTTGGGGGGTT
TTTTTTGGTTTTTTTTTTTTTTTTGGTTTTTTTTGGTTTTTTTTTTTTGGTT
TTGGGGGGGGGGGGGGGGGGGGGGGGGGGGGGGGGGGGGGGGGGGGGGGGTT
TTGGTTTTTTTTTTTTTTTTTTTTTTTTTTTTTTTTTTTTTTTTTTTTGGTT
TTGGNTGGGGGGGGGGGGGGGGGGGGGGGGGGGGGGGGGGGGGGGGTTlGTT
TTGGGGGGGGGGGGGGGGGGGGGGGGGGGGGGGGGGGGGGGGGGGGGGGGTT
TTTTTTTTTTTTTTTTTTTTTTTTTTTTTTTTTTTTTTTTTTTTTTTTTTTT