TTTTTTTTTTTTTTTTTTTTTTTTTTTTTTTTTTTTTTTTTTTTTTTTTTTTT
TTGGGGGGGGGGGGGGGGTTTTTTTTTTTTTTTTGGGGGGGGGGGGGGGGTTT
TTGGTTTTTTTTTTTTGGTTTTGGGGGGGGGGTTGGTTTTTTTTTTTTGGTTT
TTGGTTGGGGGGGGTTGGTTTTGGTTTTTTGGTTGGTTGGGGGGGGTTGGTTT
TTGGTTGGNTTTGGTTGGGGGGGGGTTTTTGGGGGGGGNTTTGGTTGGGGTTT
TTGGGGGGGGTTGGTTTTTTTTTTTTTTTTTTTTTTGGTTGGTTTTTTGGTTT
TTTTTTTTGGTTGGGGGGGGGGGGGGGGGGGGGGGGGGTTGGTTTTTTGGTTT
TTGGGGGGGGGGTTTTTTTTTTTTTTTTTTTTTTTTGGGGGGGGGGGGGGTTT
TTGGTTTTTTGGTTGGGGGGGGGGGGGGGGGGTTGGTTTTTTTTTTTTGGTTT
TTGGTTGGGGGGGGGGTTTTGGTTTPGGTTTTGGGGGGGGGGGGGGTTGGTTT
TTGGTTGGTTTTTTTTTTTTGGTTTTGGTTTTGGTTTTTTTTTTGGTTGGTTT
TTGGGGGGGGGGGGGGGGGGGGGGGGGGGGGGGGGGGGGGGGGGGGGGGGTTT
TTTTTTTTTTTTTTTTTTTTTTTTGGGGGGGGTTTTTTTTTTTTTTTTTTTTT
TTGGGGGGGGGGGGGGGGGGGGGGGGGGGGGGGGGGGGGGGGGGGGGGGGTTT
TTGGTTTTTTTTTTTTTTTTTTTTTTTTGGTTTTTTTTTTTTTTTTTTGGTTT
TTGGTTGGGGGGGGGGGGGGGGGGGGGGTTGGGGGGGGGGGGGGGGTTGGTTT
TTGGNTTTGGTTTTTTTTTTTTTTTTTTTTTTTTTTTTTTTTTTGGTTGGTTT
TTGGTTTTGGGGGGGGGGGGGGGGGGGGGNTGGGGGGGGGGGGGGGGTTdGTT
TTGGGGGGGGGGGGGGGGGGGGGGGGGGGGGGGGGGGGGGGGGGGGGGGGTTT
TTTTTTTTTTTTTTTTTTTTTTTTTTTTTTTTTTTTTTTTTTTTTTTTTTTTT