TTTTTTTTTTTTTTTTTTTTTTTTTTTTTTTTTTTTTTTTTTTTTTTTTTTTT
TTGGGGGGGGGGGGGGGGGGGGGGGGGGGGGGGGGGGGGGGGGGGGGGGGTTT
TTPGTTTTTTTTTTTTTTTTTTTTTTTTTTTTTTTTTTTTTTTTTTTTGGTTT
TTGGTTGGGGGGGGGGGGGGGGGGGGGGGGGGGGGGGGGGGGGGGGTTGGTTT
TTGGTTGGNTTTTTTTTTTTTTTTTTTTTTTTTTTTTTTTTTNGGTTGGTTTT
TTGGTTGGGGGGGGGGGGGGGGGGGGGGGGGGGGGGGGGGGGGGTTGGTTTTT
TTGGTTTTTTTTTTTTTTTTTTTTTTTTTTTTTTTTTTTTTTTTTTGGTTTTT
TTGGGGGGGGGGGGGGGGGGGGGGGGGGGGGGGGGGGGGGGGGGGGGGTTTTT
TTTTTTTTTTTTTTTTTTGGTTTTTTTTTTGGTTTTTTTTTTTTTTTTTTTTT
TTGGGGGGGGGGGGGGTTGGGGGGGGGGGGGGTTGGGGGGGGGGGGGGTTTTT
TTGGTTTTTTTTTTGGTTTTTTTTTTTTTTTTGGTTTTTTTTTTTTGGTTTTT
TTGGTTGGGGGGTTGGGGGGGGGGGGGGGGGGTTGGGGGGGGGGTTGGTTTTT
TTGGTTGGTTTTGGTTTTTTTTTTTTTTTTGGTTGGTTTTTTGGTTGGTTTTT
TTGGGGGGTTTTGGGGGGGGGGGGGGGGTTGGGGGGTTTTGGGGGGGGTTTTT
TTTTTTGGTTTTTTTTTTTTTTTTTTGGTTTTTTGGTTTTTTTTTTGGTTTTT
TTGGGGGGGGGGGGGGGGGGGGGGGGGGGGGGGGGGGGGGGGGGGGGGTTTTT
TTGGTTTTTTTTTTTTTTTTTTTTTTTTTTTTTTTTTTTTTTTTTTTTGGTTT
TTGGNTGGGGGGGGGGGGGGGGGGGGGGGGGGGGGGGGGGGGGGGGTTrTTTT
TTGGGGGGGGGGGGGGGGGGGGGGGGGGGGGGGGGGGGGGGGGGGGGGTTTTT
TTTTTTTTTTTTTTTTTTTTTTTTTTTTTTTTTTTTTTTTTTTTTTTTTTTTT