TTTTTTTTTTTTTTTTTTTTTTTTTTTTTTTTTTTTTTTTTTTTTTTTTTTT
TTGGGGGGGGGGGGGGGGGGGGGGGGGGGGGGGGGGGGGGGGGGGGGGGGTT
TTGGTTTTTTTTTTTTTTTTGGGGGGGGGGGGTTTTTTTTTTTTTTGGTTTT
TTGGTTGGGGGGGGGGTTTTGGTTTTTTTTGGTTGGGGGGGGGGTTGGTTTT
TTGGTTGGNTTTTTGGTTGGGGGGGGGGGGTTGGNTTTTTGGTTGGGGTTTT
TTGGTTGGTTTTTTGGTTTTTTTTTTTTTTTTGGTTTTTTGGTTTTGGTTTT
TTGGGGGGGGGGGGGGGGGGGGGGGGGGGGGGGGGGGGGGGGGGGGGGTTTT
TTTTTTTTTTTTTTTTTTTTTTTTTTGGTTTTTTTTTTTTTTTTTTTTTTTT
TTGGGGGGGGGGGGGGGGGGGGGGTTGGTTGGGGGGGGGGGGGGGGGGTTTT
TTGGTTTTTTTTTTTTTTTTTTGGTTGGTTGGTTTTTTTTTTTTTTGGTTTT
TTPGGTTGGGGGGGGGGGGTTGGGGGGGGGGGGTTGGGGGGGGGGTTGGTTT
TTGGTTGGTTTTTTTTGGTTTTTTTTTTTTTTGGTTTTTTTTGGTTGGTTTT
TTGGGGGGTTTTTTTTGGGGGGGGGGGGGGGGGGTTTTTTGGGGGGGGTTTT
TTTTTTGGTTTTTTTTTTTTTTTTTTTTTTTTGGTTTTTTTTTTTTGGTTTT
TTGGGGGGGGGGGGGGGGGGGGGGGGGGGGGGGGGGGGGGGGGGGGGGTTTT
TTGGTTTTTTTTTTTTTTTTTTTTTTTTTTTTTTTTTTTTTTTTTTTTGGTT
TTGGNTGGGGGGGGGGGGGGGGGGGGGGGGGGGGGGGGGGGGGGGGTTuTTT
TTGGGGGGGGGGGGGGGGGGGGGGGGGGGGGGGGGGGGGGGGGGGGGGTTTT
TTTTTTTTTTTTTTTTTTTTTTTTTTTTTTTTTTTTTTTTTTTTTTTTTTTT