TTTTTTTTTTTTTTTTTTTTTTTTTTTTTTTTTTTTTTTTTTTTTTTTTT
TPGTTGGGGGGGGGGGGGGGGGGGGGGTTGGGGGGGGGGGGGGGGGGGGT
TTGGTTGGTTTTTTTTTTTTTTTTTTGGTTGGTGGGGGGGGGTTTTTTTT
TTGGTTGGTTTTTTTTTTTTTTTTTTGGTTGGTTTTTTTGGGTTTTTTTT
TGGGTTGGGGGGGGGGGGGGGGGNTTGGGGGGTTTTGGTGGGTTGGGGGT
TTTTTTTTTTTTTTTTTTTTTTGGTTGGTTTTTTTTGGTTTTTTGGTTTT
TGGGGGGGGGGGGGGGGGGGTTGGGGGGGGGGGGGGGGGGGGTTGGGGGT
TTTTTTTTTTTTTTTTTTGGTTGGTTTTTTTTTTTTTTGGGGTTTTTTTT
TGGGGGGGGGGGGGGGTTGGTTNGTTTTTTTTTTTTTTGGGGGGGGGGGT
TTTTTTTTTTTTTTGGTTGGTTGGTTGGGGGGGGGGGGGGGGTTTTTTTT
TTTTTTTTTTTTTTGGTTGGGGGGTTGGTTTTTTTTTTTGGGTTTTTTTT
TGGGGGGGGGGGTTGGTTTTTTTTTTGGGGGGGGGGGGGGGGGGGGGGGT
TTTTTTTTTTTTGGTTTTTTTTTTTTTTGNGGGGGGGGGGGGTTTTTTTT
TGGGGGGGGGTTGGGGGGGGGGGGGGGGGGTTTTTTTTTGGGGGGGGGGT
TTTTTTTTTTTTTTTTTTTTTTTTTTTTGGGGGGGGGGGGGGTTTTTTTT
TTTTTTTTTTTTTTTTTTTTTTTTTTTTTTGGGGGGGGGGGGTTTTTTTT
TGGGGGGGGGGGGGGGNGGGGGGGGGGGGGGGTTTTTTTGGGGGGGGGGT
TTTTTTTTTTTTTTTTTTTTTTTTTTTTTTGGGGGGGGGGGGTTTTTTTT
TGGGGGGGGGGGGGGGGGGGGGGGGGGGGGTTGGGGGGGGGGGGGGGGrT
TTTTTTTTTTTTTTTTTTTTTTTTTTTTTTTTTTTTTTTTTTTTTTTTTT
