TTTTTTTTTTTTTTTTTTTTTTTTTTTTTTTTTTTTTTTTTTTTTTTTTT
TPGGGGGGGGGGGGGGGGGGGGGTTGGGGGGGGGGGGGGGGGGGGGGGGT
TTTTTTTTTTTTTGGGGGGGGGGGGTTTTTTTTTTTTTTTTTTTTTTTTT
TGGGGGGGGGGGGGGGTTTTTTTGGGGGGGGGGGGGGNGGGGGGGGGGGT
TTTTTTTTTTTTTGGGGGGGGGGGGTTTTTTTTTTTTTTTTTTTTTTTTT
TTTTTTTTTTTTTGGGGGGGGGGGGGGTTTTTTTTTTTTTTTTTTTTTTT
TGGGGGGGGGGGGGGGTTTTTTTTTGGGGGGGGGGGGGGGGGGTTGGGGT
TTTTTTTTTTTTTGGGGGGGGGNGGGGTTTTTTTTTTTTTTGGTTTTTTT
TGGGGGGGGGGGGGGGGGGGGGGGGGGGGTTTTTTTTTTGGTTGGGGGGT
TTTTTTTTTTTTTGGGTTTTTTTTTTTGGTTGGGGGGTTGGTTTTTTTTT
TTTTTTTTTTTTTGGGGGGGGGGGGGGGGTTGGTTGGTTGGTTTTTTTTT
TGGGGGGGGGGGGGNGGTTTTTTTTTTTTTTGGTTGGTTGGGGGGGGGGT
TTTTTTTTTTTTTGGGGTTTTTTTTTTTTTTGGTTGGTTTTTTTTTTTTT
TGGGGGGGGGGTTGGGGGGGGGGGGGGGGGGGGTTGGGGGGGGGGGGGGT
TTTTTTTTTGGTTTTTTGGTTTTTTTTGGTTGGTTTTTTTTTTTTTTTTT
TTTGGGGGGGGTTGGGTGGTTTTGGGNGGTTGGGGGGGGGGGGGGGGGGT
TTTGGTTTTTTTTGGGTTTTTTTGGTTGGTTTTTTTTTTTTTTTTTTGGT
TTTGGTTTTTTTTGGGGGGGGGTGGTTGGTTTTTTTTTTTTTTTTTTGGT
TGTTGGGGGGGGGGGGGGGGGGGGGGTTGGGGGGGGGGGGGGGGGGGGuT
TTTTTTTTTTTTTTTTTTTTTTTTTTTTTTTTTTTTTTTTTTTTTTTTTT
