TTTTTTTTTTTTTTTTTTTTTTTTTTTTTTTTTTTTTTTTTTTTTTTTTT
TPGGGGGGGGGGGGGGGGGGTTGGGGGGGGGGGGGGGGGGGGGGGGGGGT
TTTTTTTTTTTTTTTTTTTTGGGGGGGGGGGGTTTTTTTTTTTTTTTTTT
TGGGGGGGGGGGGGGGGGGGGGTTTTTTTGGGGGGGNGGGGGGGGGGGGT
TTTTTTTTTTTTTTTTTTTTGGGGGGGGGGGGTTTTTTTTTTTTTTTTTT
TTTTTTTTTTTTTTTTTTGGGGGGGGGGGGGGTTTTTTTTTTTTTTTTTT
TTGGGGGGGGGGGGGGGGGGTTTTTTTTTGGGGGGGGGGGGGGGGGGGTT
TTGGTTTTTTTTTTTTTTGGGGGGGGNGGGGGTTTTTTTTTTTTTTTTTT
TGTTGGTTTTTTTTTTGGGGGGGGGGGGGGGGGGGGGGGGGGGGGGGGGT
TTTTGGTTGGGGGGTTGGTTTTTTTTTTTGGGTTTTTTTTTTTTTTTTTT
TTTTGGTTGGTTGGTTGGGGGGGGGGGGGGGGTTTTTTTTTTTTTTTTTT
TGGGGGTTGGTTGGTTTTTTTTTTTTTTNGGGGGGGGGGGGGGGGGGGGT
TTTTTTTTGGTTGGTTTTTTTTTTTTTTGGGGTTTTTTTTTTTTTTTTTT
TGGGGGGGGGTTGGGGGGGGGGGGGGGGGGGGTTGGGGGGGGGGGGGGGT
TTTTTTTTTTTTGGTTGGTTTTTTTTGGTTTTTTGGTTTTTTTTTTTTTT
TGGGGGGGGGGGGGTTGGGGGGTTTTNGTGGGTTGGGGGGGGTTGGGGGT
TTTTTTTTTTTTTTTTGGTTGGTTTTTTTGGGTTTTTTTTGGTTGGTTTT
TTTTTTTTTTTTTTTTGGTTGGTGGGGGGGGGTTTTTTTTGGTTGGTTTT
TGGGGGGGGGGGGGGGGTTGGGGGGGGGGGGGGGGGGGGGGTTGGGGGdT
TTTTTTTTTTTTTTTTTTTTTTTTTTTTTTTTTTTTTTTTTTTTTTTTTT
