TTTTTTTTTTTTTTTTTTTTTTTTTTTTTTTTTTTTTTTTTTTTTTTTTT
TTPGGGGGGGGGGGGGGGGGGGGGGGGGGGGGGGGGGGGGGGGGGGGGTT
TGGGGGGGGGGGTTTTTTTTTTTTTTTTTTTTTTTTTTTTTTTTTTTTGT
TGTTTTTTTGGGGGGGGGGGGGGGGGGGGNGGGGGGGGGGGGGGGGGGGT
TGGGGGGGGGGGTTTTTTTTTTTTTTTTTTTTTTTTTTTTTTTTTTTTGT
TGGGGGGGGGGGTTTTTTTTTTTTTTTTTTTTTTTTTTTTTTTTTTGGGT
TTTTTTTTTGGGGGGGGGGGGGGGGGGGTTGGGGGGGGGGGGGGGGGGTT
TGGGGGGGGGGGTTTTTTTTTTTTTTTTTTGGTTTTTTTTTTTTTTGGGT
TGGGGGGGGGGGGGGGGGGGNGGGGGGGGGTTGGTTTTTTTTTTGGGGGT
TTTTTTTTTGGGTTTTTTTTTTTTTTTTTTTTGGTTGGGGGGTTGGTTTT
TGGGGGGGGGGGTTTTTTTTTTTTTTTTTTTTGGTTGGTTGGTTGGGGGT
TTTTTTTTGGGGGGGGGGGGGGGGGGGGGGGGGGTTNGTTGGTTTTTTTT
TTTTTTTTGGGGTTTTTTTTTTTTTTTTTTTTTTTTGGTTGGTTTTTTTT
TGGGGGGGGGGGTTGGGGGGGGGGGGGGGGGGGGGGGGTTGGGGGGGGGT
TTTTTTGGTTTTTTGGTTTTTTTTTTTTTTTTTTTTTTTTGGTTGGTTTT
TGTTTTGGTGGGTTGGGGGGGGTTGGGNGGGGGGGGGGGGGGTTGGGGGT
TGTTTTTTTGGGTTTTTTTTGGTTGGTTTTTTTTTTTTTTTTTTGGTTGT
TGTGGGGGGGGGTTTTTTTTGGTTGGTTTTTTTTTTTTTTTTTTGGTTGT
TGGGGGGGGGGGGGGGGGGGGTTGGGGGGGGGGGGGGGGGGGGGGTTGdT
TTTTTTTTTTTTTTTTTTTTTTTTTTTTTTTTTTTTTTTTTTTTTTTTTT
