TTTTTTTTTTTTTTTTTTTTTTTTTTTTTTTTTTTTTTTTTTTTTTTTTT
TPGGGGGGGGGGGGGGGGGGGGGTTGGGGGGGGGGGGGGGGGGGGGGTTT
TGTTTTTTTTGGGGGGGGGTGGTTGGTTTTTTTTTTTTTTTTTTGGTTGT
TGTTTTTTTTGGGTTTTTTTGGTTGGTTTTTTTTTTTTTTTTTTGGTTGT
TGGGGGGGTTGGGTGGTTTTGGGGGGTTGGNGGGGGGGGGGGGGGGTTGT
TTTTTTGGTTTTTTGGTTTTTTTTGGTTGGTTTTTTTTTTTTTTTTTTTT
TGGGGGGGTTGGGGGGGGGGGGGGGGGGGGTTGGGGGGGGGGGGGGGGGT
TTTTTTTTTTGGGGTTTTTTTTTTTTTTGGTTGGTTTTTTTTTTTTTTTT
TGGGGGGGGGGGGGTTTTTTTTTTTTTTGGTTGGTTNGGGGGGGGGGGGT
TTTTTTTTTTGGGGGGGGGGGGGGGGTTGGTTGGTTGGTTTTTTTTTTTT
TTTTTTTTTTGGGTTTTTTTTTTTGGTTGGGGGGTTGGTTTTTTTTTTTT
TGGGGGGGGGGGGGGGGGGGGGGGGGTTTTTTTTTTGGTTGGGGGGGGGT
TTTTTTTTTTGGGGGNGGGGGGGGTTTTTTTTTTTTTTGGTTTTTTTTTT
TGGGGGGGGGGGGTTTTTTTTTGGGGGGGGGGGGGGGGGGTTGGGGGGGT
TTTTTTTTTTGGGGGGGGGGGGGGTTTTTTTTTTTTTTTTTTTTTTTTTT
TTTTTTTTTTGGGGGGGGGGGGTTTTTTTTTTTTTTTTTTTTTTTTTTTT
TGGGGGGGGGGGGTTTTTTTGGNGGGGGGGGGGGGGGGGGGGGGGGGGGT
TTTTTTTTTTGGGGGGGGGGGGTTTTTTTTTTTTTTTTTTTTTTTTTTTT
TGGGGGGGGGGGGGGGGGGGTTGGGGGGGGGGGGGGGGGGGGGGGGGGlT
TTTTTTTTTTTTTTTTTTTTTTTTTTTTTTTTTTTTTTTTTTTTTTTTTT
