TTTTTTTTTTTTTTTTTTTTTTTTTTTTTTTTTTTTTTTTTTTTTTTTTT
TPGGGGGGGGGGGGGGGGGTTGGGGGGGGGGGGGGGGGGGGGGTTGGGGT
TTTTTTTTTTTTTTTTTTGGTTGGTGGGGGGGGGTTTTTTTTGGTTGGTT
TTTTTTTTTTTTTTTTTTGGTTGGTTTTTTTGGGTTTTTTTTGGTTGGTT
TGGGGGGGGGGGGGGGTTGGGGGGTTTTNGTGGGTTGGGGGGGGTTGGGT
TTTTTTTTTTTTTTGGTTGGTTTTTTTTGGTTTTTTGGTTTTTTTTTTTT
TGGGGGGGGGGGTTGGGGGGGGGGGGGGGGGGGGTTGGGGGGGGGGGGGT
TTTTTTTTTTGGTTGGTTTTTTTTTTTTTTGGGGTTTTTTTTTTTTTTTT
TGGGGGGGTTGGTTGGTTTTTTTTTTTTTTGGGGGGGNGGGGGGGGGGGT
TTTTTTGGTTGGTTGGTTGGGGGGGGGGGGGGGGTTTTTTTTTTTTTTTT
TTTTTTGGTTGGGGGGTTGGTTTTTTTTTTTGGGTTTTTTTTTTTTTTTT
TGGGTTGGTTTTTTTTTTGGGGGGGGGGGGGGGGGGGGGGGGGGGGGGGT
TTTTGGTTTTTTTTTTTTTTGGGGGNGGGGGGGGTTTTTTTTTTTTTTTT
TGTTGGGGGGGGGGGGGGGGGGTTTTTTTTTGGGGGGGGGGGGGGGGGGT
TTTTTTTTTTTTTTTTTTTTGGGGGGGGGGGGGGTTTTTTTTTTTTTTTT
TTTTTTTTTTTTTTTTTTTTTTGGGGGGGGGGGGTTTTTTTTTTTTTTTT
TGGGGGGGGGGGGGNGGGGGGGGGTTTTTTTGGGGGGGGGGGGGGGGGGT
TTTTTTTTTTTTTTTTTTTTTTGGGGGGGGGGGGTTTTTTTTTTTTTTTT
TGGGGGGGGGGGGGGGGGGGGGTTGGGGGGGGGGGGGGGGGGGGGGGGrT
TTTTTTTTTTTTTTTTTTTTTTTTTTTTTTTTTTTTTTTTTTTTTTTTTT
