TTTTTTTTTTTTTTTTTTTTTTTTTTTTTTTTTTTTTTTTTTTTTTTTTT
TPGGGGGGGGGGTTGGGGGGGGGGGGGGGGGGGGGGTTGGGGGGGGGGGT
TTTTTTTTTGGTTGGTTTTTTTTGGGGGGGGGTGGTTGGTTTTTTTTTTT
TTTTTTTTTGGTTGGTTTTTTTTGGGTTTTTTTGGTTGGTTTTTTTTTTT
TGGGGGGGGGGTTGGGGGGGGTTNGGTGGTTTTGGGGGGTTGGGGGGGGT
TTTTTTTTTTTTTTTTTTTGGTTTTTTGGTTTTTTTTGGTTGGTTTTTTT
TGGGGGGGGGGGGGGGGGGGGTTGGGGGGGGGGGGGGGGGGGGTTGGGGT
TTTTTTTTTTTTTTTTTTTTTTTGGGGTTTTTTTTTTTTTTGGTTGGTTT
TGGGGGGGGGGGGGGGGGGGGGGNGGGTTTTTTTTTTTTTTGGTTGGTTT
TGGTTTTTTTTTTTTTTTTTTTTGGGGGGGGGGGGGGGGTTGGTTGGTTT
TGGTTTTTTTTTTTTTTTTTTTTGGGTTTTTTTTTTTGGTTGGGGGGTTT
TGGTTGGGGGGGGGGGGGGGGGGGGGGGGGGGGGGGGGGTTTTTTTTTTT
TTTGGTTTTTTTTTTTTTTTTTTGGGGNGGGGGGGGGTTTTTTTTTTTTT
TGGGGTTGGGGGGGGGGGGGGGGGGGTTTTTTTTTGGGGGGGGGGGGGGT
TTTTTTTTTTTTTTTTTTTTTTTGGGGGGGGGGGGGGTTTTTTTTTTTTT
TTTTTTTTTTTTTTTTTTTTTTTGGGGGGGGGGGGTTTTTTTTTTTTTTT
TGGGGGGGGGGGGNGGGGGGGGGGGGTTTTTTTGGGGGGGGGGGGGGGGT
TTTTTTTTTTTTTTTTTTTTTTTGGGGGGGGGGGGTTTTTTTTTTTTTTT
TGGGGGGGGGGGGGGGGGGGGGGGGGGGGGGGGTTGGGGGGGGGGGGGlT
TTTTTTTTTTTTTTTTTTTTTTTTTTTTTTTTTTTTTTTTTTTTTTTTTT
