TTTTTTTTTTTTTTTTTTTTTTTTTTTTTTTTTTTTTTTTTTTTTTTTTT
TPGGGGGTTGGGGGGGGGGGGGGGGGGGGGGTTGGGGGGGGGGGGGGGGT
TTTTTTGGTTGGTGGGGGGGGGTTTTTTTTGGTTGGTTTTTTTTTTTTTT
TTTTTTGGTTGGTTTTTTTGGGTTTTTTTTGGTTGGTTTTTTTTTTTTTT
TGGGTTGGGGGGTTTTGGTGGGTTGNGGGGGGTTGGGGGGGGGGGGGGGT
TTGGTTGGTTTTTTTTGGTTTTTTGGTTTTTTTTTTTTTTTTTTTTTTTT
TTGGGGGGGGGGGGGGGGGGGGTTGGGGGGGGGGGGGGGGGGGGGGGGTT
TTGGTTTTTTTTTTTTTTGGGGTTTTTTTTTTTTTTTTTTTTTTTTGGTT
TTGGTTTTTTTTTTTTTTGGGGGGGNGGGGGGGGGGGGGGGGGGTTGGTT
TTGGTTGGGGGGGGGGGGGGGGTTTTTTTTTTTTTTTTTTTTGGTTGGTT
TGGGTTGGTTTTTTTTTTTGGGTTTTTTTTTTTTTTTTTTTTGGTTGGGT
TTTTTTGGGGGGGGGGGGGGGGGGGGGGGGGGGGGGGGGGTTGGTTTTTT
TTTTTTTTGGGGGNGGGGGGGGTTTTTTTTTTTTTTTTTTGGTTTTTTTT
TGGGGGGGGGTTTTTTTTTGGGGGGGGGGGGGGGGGGGTTGGGGGGGGGT
TTTTTTTTGGGGGGGGGGGGGGTTTTTTTTTTTTTTTTTTTTTTTTTTTT
TTTTTTTTTTGGGGGGGGGGGGTTTTTTTTTTTTTTTTTTTTTTTTTTTT
TGGGGGGGGGGGTTTTTTTGGGNGGGGGGGGGGGGGGGGGGGGGGGGGGT
TTTTTTTTTTGGGGGGGGGGGGTTTTTTTTTTTTTTTTTTTTTTTTTTTT
TGGGGGGGGGTTGGGGGGGGGGGGGGGGGGGGGGGGGGGGGGGGGGGGrT
TTTTTTTTTTTTTTTTTTTTTTTTTTTTTTTTTTTTTTTTTTTTTTTTTT
