TTTTTTTTTTTTTTTTTTTTTTTTTTTTTTTTTTTTTTTTTTTTTTTTTT
TPGGGGGGGGGGGGGGGGGGGGGGGGGGGGGGGGGGGGGGGGGTTGGGGT
TTTTTTTTTTTTTTTTTTTTTTTTTTTTTTTTTGGGGGGGGGGGGTTTTT
TGGGGGGGGGGGGGGGGGGGGGGGGGGGGGNGGGGGTTTTTTTGGGGGGT
TTTTTTTTTTTTTTTTTTTTTTTTTTTTTTTTTGGGGGGGGGGGGTTTTT
TTTTTTTTTTTTTTTTTTTTTTTTTTTTTTTTTGGGGGGGGGGGGGGTTT
TGGGGGGGGGGGGGGTTGGGGGGGGGGGGGGGGGGGTTTTTTTTTGGGGT
TTTTTTTTTTTTTGGTTTTTTTTTTTTTTTTTTGGGGGGGGGGGGGGTTT
TTTTTTTTTTTGGTTGGGNGGGGGGGGGGGGGGGGGGGGGGGGGGGGGGT
TTTGGGGGGTTGGTTTTTTTTTTTTTTTTTTTTGGGTTTTTTTTTTTGGT
TTTGGTTGGTTGGTTTTTTTTTTTTTTTTTTTTGGGGGGGGGGGGGGGGT
TTTGGTTGGTTGGGGGGGGGGGGGGGGGGGGGNGGGGTTTTTTTTTTTTT
TTTGGTTGGTTTTTTTTTTTTTTTTTTTTTTTTGGGGTTTTTTTTTTTTT
TGGGGTTGGGGGGGGGGGGGGGGGGGGGGGGTTGGGGGGGGGGGGGGGGT
TTTGGTTTTTTTTTTTTTTTTTTTTTTTTGGTTTTTTGGTTTTTTTTGGT
TTTGGGGGGGGGGGGGGGGGGTTGGGGNGGGTTGGGTGGTTTTGGGGGGT
TTTTTTTTTTTTTTTTTTTGGTTGGTTTTTTTTGGGTTTTTTTGGTTGGT
TTTTTTTTTTTTTTTTTTTGGTTGGTTTTTTTTGGGGGGGGGTGGTTGGT
TGGGGGGGGGGGGGGGGGGGGGTTGGGGGGGGGGGGGGGGGGGGGGTTuT
TTTTTTTTTTTTTTTTTTTTTTTTTTTTTTTTTTTTTTTTTTTTTTTTTT
