TTTTTTTTTTTTTTTTTTTTTTTTTd#8TTTTTTTTTTTTTTTTTTTTTTTTT
TGGGGGGGGGGGGGGGGGGGGGGGT7#8TGGGGGGG!)))))))))))@GGGT
TGGGGGGGGGGGGGGGGGGGGGGGT7#8TGGTTTGG&WWWWWWWWWWW(GGGT
TGGGGGGGGGGGGGGGGGGGGGGGTB#8TGGTTGGG&WWWWWWWWWWW(GGGT
TGGGGGGGGGGGGGGGGGGGGGGGT7#8GGGGGGGG%$$$$$$$$$$$^GGGT
TGGGGGGGGGGGGGGGGGGGGGGGT7#26666666661#8GGGGGGGGGGGGT
TGGGGGGGGGGGGGGGGGGGGGGGT7#############8GGGGGGGGGGGGT
TGGGGGGGGGGGGGGGGGGGGGGGT7#455555555555GGGGGGGGGGGGGT
TGGGGGGGGGGGGGGGGGGGGGGGT7#8TGGGGGGGGGGGGTTTTTGGGGGGT
TGGGGGGGGGGGGGGGGGGGGGGGT7#8TGGGGGGGGGGGGGTTTGGGGGGGT
TGGGGGGGGGGGGGGGGGGGGGGGT7#8TGGGGGGGGGGGGGGGGGGGGGGGT
TTTTTTTTTTTTTTTTTTTTTTTTT7#8TTTTTTTTTTTTTTTTTTTTTTTTT
l6666O66666666666666666661#2666666666666666666S6666r6
##########################P##########################
55555555555555555555555553#45555555555555555555555555
TTTTTTTTTTTTTTTTTTTTTTTTT7#8TTTTTTTTTTTTTTTTTTTTTTTTT
TGGGGGGGGGGGGGGGGGGGGGGGT7#8TGGGGGGGGGGGGGGGGGGGGGGGT
TGGGGGGGGGGGGGGGGGGGGGGGT7#8TGGGGGGGGGGGGGGGGGGGGGGGT
TGGGGGGGGGGGGGGGGGGGGGGGT7#8TGGGGGGGGGGGGGGGGGGGGGGGT
TGGGGGGGGGGGGGGGG666666661#8TGGGGGGGGGGGGGGGGGGGGGGGT
TGGGGGGGGGGGGGGGG##########8TGGGGGGGGGGGGGGGGGGGGGGGT
TGGGGGGGGGGGGGGGG555555553#8TGGGGGGGGGGGGGGGGGGGGGGGT
TGGGGGGGGGGGGGGGGGGGGGGGT7#8TGGGGGGGGGGGGGGGGGGGGGGGT
TGGGGGGGGGGGGGGGGGGGGGGGTK#8TGGGGGGGGGGGGGGGGGGGGGGGT
TGGGGGGGGGGGGGGGGGGGGGGGT7#8TGGGGGGGGGGGGGGGGGGGGGGGT
TGGGGGGGGGGGGGGGGGGGGGGGTu#8TGGGGGGGGGGGGGGGGGGGGGGGT
TTTTTTTTTTTTTTTTTTTTTTTTT7#8TTTTTTTTTTTTTTTTTTTTTTTTT