TTTTTTTTTTTTTTTTTTTTTTTTTTTTTTTTTTTTTTTTTTTTTTTTTTTTT
TTTTTTNGGGGGGGGGGGGGGGGGT7#8TGGGGGGG!)))))))))))@GGGP
TTTTTGGGGGGTTTTTTTTGGGGGT7#8TGGTTTGG&WWWWWWWWWWW(GGGT
TGGGGGGGGGGTTGGGGGGGGGGGT7#8TGGTTGGG&WWWWWWWWWWW(GGGT
TGGGTGGGGGGTTGGGGGGTTTTTT7#8GGGTTGGG%$$$$$$$$$$$^GGGT
TGNGTGGGGGGTTNGGGGGGGGGGGGGGGGGTTGGGTTTTTTTGGGGGGGGGT
TGGGGTTTTTGTTTTTTTTTTTTTTTTTTTTTTTGGTTTTTGGGTTTTTTTTT
TGGGTGGGTGGGGGGGGGGGTGGGGGGTTTTTTTGGTTTTGGGNTTTTTTTTT
TGGGGTGTGGGTTTGGGGGGTGGGTGGTTTTTTTGGGGGGGTTTTTTTTTTTT
TGGGGGTGGGGTTGGGGTTTGGGGTGGTTTTTTTTTTTTTTTTTTTTTTTTTT
TNGGGGGGGGGTTGGGTGGGGGTTTGGGTTTTTTTGGGGGGGGGGGGGGGGGT
TGGGGGGGGGGTTGGGGGGGGGTNGGGGGGGGGGGGGGGGGTTGGGGGGGGGG
TTTTTTTTTTTTTTTTTTTTTTTTTTTTTTTTTTTTTTTTTTTTTTTTTTTTT