TTTTTTTTTTTTTTTTTTTTTTTTTTTTTTTTTTTTTTTTTTTTTTTTTTTTT
TTTTTTGGGGGGGTTTTTTTTTTTGGGGGGGGTTTTTTTTNTTTTGGGGGGTT
TTTTTGGGTTTTGGGGGGTTTTTGGTTTGGGTTGGGGGGGGTTTTGGTTGGTT
TTTTTGGGTTTTTTGGGGTTTTGGGTTTGGTTTGGTTTGGGGTTTGGTTGGTT
TTTTGGGTTTTTNGGGGGGGGGGGGTTTGGTTTGGTTTTTGGGTTGGTTGGTT
TTTGGTTTTTTTTTTTTTTTTTTTTTTTGGGGGGGTTTTTTGGGGGGTTGGTT
TTTGGGGGGGTTTTGGGGGGGGTTGGGTTTTTTTTTTTTTTTTTTTTTTGGTT
TTTTTGTTGGGHGGGGTTTTGGTTGTGTTTGGGGGGGGGTTTTTTTGGGGGTT
TTTTTTTTTTTTTGGTTTTGGGNTGTGGGGGGGTTTTGGTTTTTTGGGGTTTT
TTTTGGGGGGGGTTTTTTTGGGTTGGTTTTTTTTTTTTGTTTTNGGGGTTTTT
TTTTGGTTTTGGTTTTTTGGGGTTTGGGTTTTTTTTTTGGTTGGGGTTTTTTT
GGGGGGNTTTGGGGGGGGGGGTTTTTTGGGTTTTTTTTGGGGGGGTTTTTTTT
TTTTTTTTTTTTTTTTTTTTTTTTTTTTTPTTTTTTTTTTTTTTTTTTTTTTT